X          ....
...    ..    ..
..       ..   .
...  ..   ..  .
.    ..   .  ..
. ..  . ....  O
..     ..    ..
....      ..  .
.     ...    ..
. . ...  .    .
. .  .    .  ..
.  .    ..    .
. .   .  . .  .
....        . .
...............