X          ....
...    ..    ..
..             
...  ..   ..  .
..   ..      ..
....    ....  O
..     ..    ..
....      ..  .
..    ...    ..
... ...  .     
...          ..
....    ..   ..
...   .  ... ..
....        ...
.........   ...